{
	"levelData": 7,
	"BlockColums": 13,
	"BlockRows": 15,
	"BlockSpawns": [ 
		1, 16, 31, 46, 61, 76, 91, 106, 121, 136, 151, 166, 181,
		3,18,33,48,63,78,93,108, 123, 138,153, 168, 183,
									 5,20,35,50,65,80,95,110, 125, 140,155, 170, 185,
									 7, 22, 37, 52, 67, 82, 97, 112, 127, 142, 157, 172, 187,
									 9, 24, 39, 54, 69, 84, 99, 114, 129, 144, 159, 174, 189,
									 11, 26, 41, 56, 71, 86, 101, 116, 131, 146, 161, 176, 191,
		3,
		18,
		33,
		48,
		63,
		78,
		93,
		108,
		123,
		138,
		153,
		168,
		183,
		13,28,43,58,73,88,103,118,133,148,163,178,193
	],


	"EnemySpawn":  [3, 46,155,172,118,84,185]
}